15 9 
###############
#.............#
#...n.....n...#
#.............#
#......a.######
#........#.....
#...+....######
#.........+...#
###############
